################
#P________######
########_____E##
################
################
################
################
################